###############################
*-----------------------#######
#-----------------------#######
##########-###########--#######
##########-###########--#######
##########-###########--#######
##########-###########--#######
##########-###########--#######
##########-###########--#######
#########---##########--#######
#########---##########--####@##
#########-#-##########------L-#
######################--------#
######################--------#
###############################