#######################
#---------###---------#
#---------------------#
#---------------------@
#---------------------#
#---------------------#
##--------###--------##
##-------#####-------##
#--------#####--------#
#--------#####--------#
#--------#####--------#
##-------------------##
##-------------------##
#---------------------#
#---------------------#
#---------------------#
###########-###########
#######################