#######%------%########
#------%%%%%%%%-------#
#---------------------#
#---------------------x
#---------------------#
#---------------------#
##--------%%%%-------##
##-------%%%%%%------##
#-------%%%%%%%%------#
#-------%%%%%%%%------#
#--------%%%%%%-------#
##--------%%%%-------##
##-------------------##
#---------------------#
#---------------------#
##-------------------##
###########@###########
#######################
