#######--------########
#-----%%%%%%%%%%------#
#-----%--------%------#
#---------------------@
#---------------------#
#---------------------#
##--------%%%--------##
##-------%%%%%-------##
#--------%%%%%--------#
#--------%%%%%--------#
#--------%%%%%--------#
##-------------------##
##-------------------##
#---------------------#
#---------------------#
#---------------------#
###########@###########
#######################