########@########
########-########
########-########
-##----------###-
-----------------
-----------------
-----------------
-----------------
#---------------#
#---------------#
#---------------#
#---------------#
#---------------#
#---------------#
#---------------#
#---------------#
#---------------#
#---------------#
#---------------#
#-------*-------#
#################