#################
########@########
########^########
###     ^    ####
#               #
#               #
#               #
#               #
#               #
#               #
#               #
#               #
#               #
#               #
#               #
#               #
#               #
#               #
#               #
#       *       #
#################