######## ########
######## ########
######## ########
 ##          ###




#               #
#               #
#               #
#               #
#               #
#               #
#               #
#               #
#               #
#               #
#               #
#       *       #
#################