######## ########
######## ########
######## ########
###          ####
#               #
#               #
#               #
#               #
#               #
#               #
#               #
#               #
#               #
#               #
#               #
#               #
#               #
#               #
#               #
#       *       #
#################