########
@------#
#---%%%#
#------#
#-%----#
#-%----#
#-%----#
########