######
#@---#
#----#
#----#
#----#
#----#
#----#
###*##