#################
########@########
########^########
###   /^^^\  ####
#     /^^^\     #
#     /^^^\     #
#     /^^^\     #
#     /^^^\     #
#     /^^^\     #
#     /^^^\     #
#     /^^^\     #
#     /^^^\     #
#     /^^^\     #
#     /^^^\     #
#     /^^^\     #
#     /^^^\     #
#     /^^^\     #
#     /^^^\     #
#     /^^^\     #
#     /^*^\     #
#################